HUM = "countries/Human.txt"
BAD = "countries/Badlands.txt"
HED = "countries/Edinmire.txt"
HBR = "countries/Brandon.txt"
TCA = "countries/Cat.txt"
PAT = "countries/Panters.txt"
LIO = "countries/Lions.txt"
BIG = "countries/Bigcats.txt"
TIE = "countries/Tigers.txt"
FAN = "countries/Fanmeir.txt"
ODR = "countries/Odragon.txt"
LIN = "countries/Lintle.txt"
HEM = "countries/Hemming.txt"
KNO = "countries/Knockford.txt"
LON = "countries/Longroad.txt"
PIN = "countries/Pinewood.txt"
SIB = "countries/SouthernImperialBasitins.txt"
LEI = "countries/Leighton.txt"
TEM = "countries/Templar.txt"
TIM = "countries/Timber.txt"
CHO = "countries/Hollow.txt"
WRE = "countries/Wreathwood.txt"
WHI = "countries/Whitefield.txt"
TWI = "countries/TwinLakes.txt"
OWH = "countries/OldWhitefield.txt"
MAH = "countries/MarchHill.txt"
WAT = "countries/Waterhold.txt"
SAR = "countries/Sarn.txt"
FTN = "countries/FreeTownNorth.txt"
NTU = "countries/NorthernTundra.txt"
SLT = "countries/SnowLeopardTerritory.txt"
RIV = "countries/Riverton.txt"
NOT = "countries/NorthwickTraders.txt"
SNO = "countries/Snowfield.txt"
SHR = "countries/ShatteredRock.txt"
WBA = "countries/WeasternBasitins.txt"
EBA = "countries/EasternBasitins.txt"
RBA = "countries/RepublicBasitins.txt"
FBA = "countries/ForestBasitins.txt"
TBA = "countries/TambielBasitins.txt"
ZBA = "countries/Zalibden.txt"
IBA = "countries/Ibiriym.txt" 
PBA = "countries/Pawilles.txt"
YBA = "countries/Ymland.txt"
NBA = "countries/NorthernBasitins.txt"
FOX = "countries/Fox.txt"
DOF = "countries/DogFox.txt"
DOW = "countries/DogWolf.txt"
CWC = "countries/WestCoastClan.txt"
CSF = "countries/ClanSmallForest.txt"
CLF = "countries/ClanLakeForest.txt"
MOE = "countries/MoelygarthClan.txt"
GWC = "countries/GreatWolfClan.txt"
MIL = "countries/Mildevagen.txt"
FIG = "countries/Figyn.txt"
MAW = "countries/MaesMawr.txt"
LIW = "countries/Liwynderw.txt"
BIT = "countries/Bitharm.txt"
SEW = "countries/SeaWolf.txt"
FOR = "countries/ForestWolf.txt"
PBB = "countries/PortByTheBay.txt"
NFW = "countries/NorthernForestWolf.txt"
DRM = "countries/DragonMountain.txt"
SAN = "countries/Clansanfraid.txt"
LCS = "countries/LowerClanSnowWolves.txt"
DIT = "countries/Ditteridge.txt"
CAL = "countries/CallowHill.txt"
RID = "countries/Ridgegate.txt"
GWP = "countries/GuardiansWhitePass.txt"
PIW = "countries/Pinehill.txt"
CSP = "countries/ClanSouthPines.txt"
CNP = "countries/ClanNorthPines.txt"
HWL = "countries/Hawling.txt"
BWT = "countries/BasitinWolfTerrytory.txt"
HEY = "countries/HeywoodClan.txt"
SNW = "countries/Snowshill.txt"
BFT = "countries/BasitinFrozenTerrytory.txt"
TFW = "countries/TheFrozenWeastes.txt"
SAD = "countries/SouthernArcticDesert.txt"